const q_data weights[10][84] = {{ 1, 2, -5, -56, 9, -26, 13, -32, 15, -30, -67, -13, -25, -36, -23, -20, 15, -18, 9, -1, -31, -18, 14, -68, -34, 8, -2, 21, 2, -21, -7, -4, 20, -2, -7, 9, 13, -8, 11, -1, -31, 21, -13, 29, -27, -19, 9, -58, -23, -12, -23, -46, -18, -1, -3, 16, -42, 30, -24, 37, 15, -36, 11, -3, 10, -23, 36, 12, -23, -14, -46, 7, -8, 1, -50, -76, -3, -7, -98, -30, -14, -59, -14, -28},
{ 0, -25, 30, 17, -20, -52, 4, -2, -39, -31, -10, -14, 31, 16, -4, -15, 13, -3, 2, -2, 8, 5, -14, -34, -19, 9, -25, 6, 6, 17, 6, -27, -31, 2, -30, -3, -40, -21, -35, -32, -2, -23, -47, 31, 9, -60, -2, 4, 4, 9, -23, 14, 11, -25, -57, -106, 8, -74, 3, 9, -67, 15, 15, -17, -28, -37, -52, -2, -7, -37, -49, -12, -2, 0, 14, 28, -10, -13, -46, 22, -12, 3, -7, 20},
{ -10, -58, 29, -2, 4, 7, 12, 11, 24, -3, -38, -20, 8, 17, 1, 5, -38, -4, 5, 22, 19, 9, 8, 7, -28, -24, 17, -29, -17, 6, -2, -18, 8, -8, 22, -15, -12, 12, -45, 22, -6, 29, -18, -50, 7, -33, -22, -21, -29, 20, 4, -20, -8, -32, -46, 8, -6, -14, -56, -9, 13, 21, -43, -12, -28, 20, -27, -17, 13, 10, -15, -30, 6, -7, -20, -31, 1, -6, -66, -32, -46, -19, 7, -6},
{ 7, -24, -47, 7, 13, -8, -25, -18, -3, 15, -21, -15, -31, -9, 6, -18, -13, -32, 5, -16, 31, 10, 20, 25, -27, -39, -20, 23, -9, 9, -53, 19, 12, -28, -25, -31, 17, 11, -28, 16, 3, -36, -28, -50, -10, -21, -15, 15, 4, -3, -8, 26, -60, 15, -10, -13, -21, -25, -13, -16, 9, 0, -19, 7, -29, -2, -16, -30, 19, 10, 13, 12, -41, 11, 29, -27, -14, -15, -105, -39, 4, -20, 7, -78},
{ 3, 1, -2, -18, -11, 15, 20, -24, -16, 12, 18, -19, -8, 6, 5, 20, 16, 27, -25, -10, 19, 2, -59, -46, 28, -5, 4, -19, -20, 28, -32, -40, -7, 2, 18, -5, -21, -45, -25, -8, 14, 19, -11, -34, -34, 14, -16, -38, -3, -19, -3, -15, -43, -2, -64, -30, 11, 1, -50, -27, -4, 0, 17, -28, 0, -36, -70, 16, -26, -9, -16, -52, 30, -9, -35, 4, 6, -16, 5, 18, -10, -35, 2, 14},
{ 11, 26, -15, -43, -10, -38, -17, 11, -11, 10, 12, 2, -35, -23, 5, 3, -31, -23, -8, 9, -31, 2, -44, 11, -12, -36, 16, 0, 29, -22, -16, 19, 23, -1, -11, -54, -3, 11, 19, -19, 9, 17, -46, -23, 10, 17, 16, -3, 9, -13, -23, 22, -11, -6, 14, -16, 0, -34, -127, -10, -4, 0, 18, -24, 2, -30, -39, -17, -36, -15, 19, 19, -26, -10, -2, -22, -18, -22, -42, 6, 31, -3, -7, 2},
{ 9, 22, -6, -31, 10, -51, 17, 17, -20, -45, -26, -43, -26, -22, 1, 14, 20, 4, 5, 23, 0, 18, -21, -9, 6, 5, -39, -59, 9, 12, 3, -37, -46, 5, 10, -1, 12, 0, 22, -31, -26, -7, -67, -8, -7, 26, -9, -27, -11, -22, -23, -51, 45, -50, -55, -23, -13, 6, -29, -54, 21, -37, -14, -35, 1, -35, 1, -16, -11, 4, -12, 14, -43, -8, -14, -8, -1, -1, 7, -11, 2, -23, 7, -26},
{ 11, -52, -23, -11, -49, -1, -28, -12, -4, 2, -19, 5, 27, 18, -10, -49, -24, -45, -4, -31, 23, 10, -17, -29, 20, 19, 14, -27, -38, -28, -22, 17, -39, -34, 15, -18, -28, -12, 6, -11, 12, -51, -4, 20, -31, 6, -1, 7, -36, 0, 7, -38, -85, 15, -16, 14, -41, -44, -26, -4, -44, 5, 28, 7, 18, 19, -39, 6, 14, -12, -2, -29, 13, -12, 2, 17, -4, -7, -42, -43, 15, -6, -10, 10},
{ 6, 20, -39, -14, -29, 4, 8, 22, 26, -45, 31, -27, -12, -39, -7, -59, -26, 9, 15, -35, -70, -46, 26, 12, -40, 13, -13, -6, -37, 5, -13, -16, -35, 20, -7, -5, 28, -23, -8, 8, -14, -6, -36, -10, 23, -8, -22, 3, 21, 3, -15, -60, -28, -10, -36, -35, 8, -13, -14, -39, 19, 6, -13, 16, 17, 1, -15, -60, 11, -2, 29, -16, 15, -7, 15, -45, 1, -15, -68, 3, -30, -10, -2, -5},
{ 11, -6, -19, -8, -38, 24, 1, -8, -31, 0, 14, -6, -3, -33, 0, -20, 21, 15, -72, -4, -23, -27, 17, -20, 14, 6, -6, 0, -30, -41, -20, 8, 20, -45, -3, -12, -22, -17, 31, 11, 14, -19, -24, -8, -32, -4, -3, -7, -30, -53, -24, 11, -49, 16, -12, -17, 19, 12, -5, 27, -39, 20, -50, 6, 1, 9, -7, 0, 13, -15, 6, -6, 0, -9, -25, 24, -9, -5, -18, 6, -10, -23, 9, 13}};