ap_int<8> image_array[1][32][32] = {{{0, 0, 0, 0, 0, 0, 0, 0, 0, 0, 0, 0, 0, 0, 0, 0, 0, 0, 0, 0, 0, 0, 0, 0, 0, 0, 0, 0, 0, 0, 0, 0},
{0, 0, 0, 0, 0, 0, 0, 0, 0, 0, 0, 0, 0, 0, 0, 0, 0, 0, 0, 0, 0, 0, 0, 0, 0, 0, 0, 0, 0, 0, 0, 0},
{0, 0, 0, 0, 0, 0, 0, 0, 0, 0, 0, 0, 0, 0, 0, 0, 0, 0, 0, 0, 0, 0, 0, 0, 0, 0, 0, 0, 0, 0, 0, 0},
{0, 0, 0, 0, 0, 0, 0, 0, 0, 0, 0, 18, 34, 39, 52, 71, 71, 48, 31, 11, 0, 0, 0, 0, 0, 0, 0, 0, 0, 0, 0, 0},
{0, 0, 0, 0, 0, 0, 0, 0, 0, 0, 25, 65, 89, 94, 108, 127, 127, 103, 81, 36, 3, 0, 0, 0, 0, 0, 0, 0, 0, 0, 0, 0},
{0, 0, 0, 0, 0, 0, 0, 0, 0, 21, 75, 114, 126, 124, 118, 109, 114, 124, 118, 66, 16, 0, 0, 0, 0, 0, 0, 0, 0, 0, 0, 0},
{0, 0, 0, 0, 0, 0, 0, 0, 4, 75, 116, 124, 115, 100, 82, 58, 71, 113, 125, 90, 35, 0, 0, 0, 0, 0, 0, 0, 0, 0, 0, 0},
{0, 0, 0, 0, 0, 0, 0, 1, 25, 106, 125, 110, 62, 12, 4, 0, 6, 86, 119, 93, 38, 0, 0, 0, 0, 0, 0, 0, 0, 0, 0, 0},
{0, 0, 0, 0, 0, 0, 0, 2, 35, 109, 112, 57, 10, 1, 0, 4, 53, 110, 125, 75, 20, 0, 0, 0, 0, 0, 0, 0, 0, 0, 0, 0},
{0, 0, 0, 0, 0, 0, 0, 0, 7, 30, 30, 13, 1, 0, 0, 6, 90, 120, 126, 73, 18, 0, 0, 0, 0, 0, 0, 0, 0, 0, 0, 0},
{0, 0, 0, 0, 0, 0, 0, 0, 0, 4, 3, 1, 0, 0, 7, 45, 113, 125, 113, 54, 8, 0, 0, 0, 0, 0, 0, 0, 0, 0, 0, 0},
{0, 0, 0, 0, 0, 0, 0, 0, 0, 0, 0, 0, 0, 7, 35, 97, 123, 121, 79, 28, 1, 0, 0, 0, 0, 0, 0, 0, 0, 0, 0, 0},
{0, 0, 0, 0, 0, 0, 0, 0, 0, 0, 0, 0, 0, 15, 63, 125, 126, 102, 42, 8, 0, 0, 0, 0, 0, 0, 0, 0, 0, 0, 0, 0},
{0, 0, 0, 0, 0, 0, 0, 0, 0, 0, 0, 0, 12, 44, 90, 125, 113, 62, 16, 0, 0, 0, 0, 0, 0, 0, 0, 0, 0, 0, 0, 0},
{0, 0, 0, 0, 0, 0, 0, 0, 0, 0, 0, 1, 42, 103, 123, 121, 71, 17, 1, 0, 0, 0, 0, 0, 0, 0, 0, 0, 0, 0, 0, 0},
{0, 0, 0, 0, 0, 0, 0, 0, 0, 0, 0, 10, 61, 120, 124, 107, 22, 3, 0, 0, 0, 0, 0, 0, 0, 0, 0, 0, 0, 0, 0, 0},
{0, 0, 0, 0, 0, 0, 0, 0, 0, 0, 0, 52, 107, 126, 116, 69, 5, 0, 0, 0, 0, 0, 0, 0, 0, 0, 0, 0, 0, 0, 0, 0},
{0, 0, 0, 0, 0, 0, 0, 0, 0, 0, 22, 81, 122, 118, 85, 17, 1, 0, 0, 0, 0, 0, 0, 0, 0, 0, 0, 0, 0, 0, 0, 0},
{0, 0, 0, 0, 0, 0, 0, 0, 0, 5, 57, 106, 126, 111, 64, 1, 0, 0, 0, 0, 0, 0, 0, 0, 0, 0, 0, 0, 0, 0, 0, 0},
{0, 0, 0, 0, 0, 0, 0, 0, 0, 34, 92, 121, 116, 82, 28, 0, 0, 0, 0, 0, 0, 0, 0, 0, 0, 0, 0, 0, 0, 0, 0, 0},
{0, 0, 0, 0, 0, 0, 0, 0, 0, 75, 115, 126, 95, 38, 3, 0, 0, 0, 0, 0, 0, 0, 0, 0, 0, 0, 0, 0, 0, 0, 0, 0},
{0, 0, 0, 0, 0, 0, 0, 0, 0, 101, 125, 126, 78, 11, 3, 3, 3, 3, 1, 0, 0, 1, 3, 3, 5, 20, 23, 23, 23, 16, 1, 0},
{0, 0, 0, 0, 0, 0, 0, 0, 0, 101, 125, 126, 89, 38, 32, 32, 32, 32, 22, 15, 15, 22, 32, 32, 38, 76, 84, 84, 84, 62, 12, 0},
{0, 0, 0, 0, 0, 0, 0, 0, 0, 99, 125, 126, 126, 126, 126, 126, 126, 126, 99, 80, 79, 98, 126, 126, 126, 126, 124, 123, 122, 102, 48, 0},
{0, 0, 0, 0, 0, 0, 0, 0, 0, 72, 114, 126, 126, 126, 126, 126, 126, 126, 124, 123, 123, 124, 126, 124, 123, 123, 98, 73, 63, 52, 24, 0},
{0, 0, 0, 0, 0, 0, 0, 0, 0, 13, 54, 73, 73, 73, 77, 93, 124, 126, 126, 104, 81, 73, 67, 39, 24, 23, 18, 13, 11, 9, 4, 0},
{0, 0, 0, 0, 0, 0, 0, 0, 0, 0, 12, 19, 19, 19, 20, 26, 39, 39, 39, 31, 22, 19, 17, 6, 0, 0, 0, 0, 0, 0, 0, 0},
{0, 0, 0, 0, 0, 0, 0, 0, 0, 0, 0, 0, 0, 0, 0, 0, 0, 0, 0, 0, 0, 0, 0, 0, 0, 0, 0, 0, 0, 0, 0, 0},
{0, 0, 0, 0, 0, 0, 0, 0, 0, 0, 0, 0, 0, 0, 0, 0, 0, 0, 0, 0, 0, 0, 0, 0, 0, 0, 0, 0, 0, 0, 0, 0},
{0, 0, 0, 0, 0, 0, 0, 0, 0, 0, 0, 0, 0, 0, 0, 0, 0, 0, 0, 0, 0, 0, 0, 0, 0, 0, 0, 0, 0, 0, 0, 0},
{0, 0, 0, 0, 0, 0, 0, 0, 0, 0, 0, 0, 0, 0, 0, 0, 0, 0, 0, 0, 0, 0, 0, 0, 0, 0, 0, 0, 0, 0, 0, 0},
{0, 0, 0, 0, 0, 0, 0, 0, 0, 0, 0, 0, 0, 0, 0, 0, 0, 0, 0, 0, 0, 0, 0, 0, 0, 0, 0, 0, 0, 0, 0, 0}}}