ap_int<8> image_array[1][32][32] = {{{0, 0, 0, 0, 0, 0, 0, 0, 0, 0, 0, 0, 0, 0, 0, 0, 0, 0, 0, 0, 0, 0, 0, 0, 0, 0, 0, 0, 0, 0, 0, 0},
{0, 0, 0, 0, 0, 0, 0, 0, 0, 0, 0, 0, 0, 0, 0, 0, 0, 0, 0, 0, 0, 0, 0, 0, 0, 0, 0, 0, 0, 0, 0, 0},
{0, 0, 0, 0, 0, 0, 0, 0, 0, 0, 0, 0, 0, 0, 0, 0, 0, 0, 0, 0, 0, 0, 0, 0, 0, 0, 0, 0, 0, 0, 0, 0},
{0, 0, 0, 0, 0, 0, 0, 0, 0, 0, 0, 0, 0, 0, 0, 0, 0, 0, 0, 0, 0, 0, 0, 0, 0, 0, 0, 0, 0, 0, 0, 0},
{0, 0, 0, 0, 0, 0, 0, 0, 0, 0, 0, 0, 0, 0, 0, 0, 0, 0, 0, 0, 0, 0, 0, 0, 0, 0, 0, 0, 0, 0, 0, 0},
{0, 0, 0, 0, 0, 0, 0, 0, 0, 0, 2, 18, 26, 16, 4, 0, 0, 0, 0, 0, 0, 0, 0, 0, 2, 10, 4, 0, 0, 0, 0, 0},
{0, 0, 0, 0, 0, 0, 0, 0, 0, 1, 22, 70, 88, 52, 10, 0, 0, 0, 0, 0, 0, 0, 0, 3, 25, 48, 21, 2, 0, 0, 0, 0},
{0, 0, 0, 0, 0, 0, 0, 0, 0, 11, 85, 120, 103, 54, 0, 0, 0, 0, 0, 0, 0, 0, 2, 17, 104, 115, 48, 7, 0, 0, 0, 0},
{0, 0, 0, 0, 0, 0, 0, 0, 9, 74, 114, 98, 45, 3, 0, 0, 0, 0, 0, 0, 0, 0, 12, 69, 122, 68, 17, 0, 0, 0, 0, 0},
{0, 0, 0, 0, 0, 0, 0, 1, 28, 103, 124, 68, 12, 0, 0, 0, 0, 0, 0, 0, 0, 5, 36, 115, 95, 29, 4, 0, 0, 0, 0, 0},
{0, 0, 0, 0, 0, 0, 1, 11, 60, 114, 89, 33, 2, 0, 0, 0, 0, 0, 0, 0, 6, 37, 94, 123, 63, 12, 0, 0, 0, 0, 0, 0},
{0, 0, 0, 0, 0, 0, 9, 54, 102, 111, 51, 10, 0, 0, 0, 0, 0, 0, 0, 0, 17, 65, 118, 95, 25, 3, 0, 0, 0, 0, 0, 0},
{0, 0, 0, 0, 0, 0, 15, 84, 124, 102, 33, 2, 0, 0, 0, 0, 0, 0, 1, 17, 51, 95, 111, 41, 3, 0, 0, 0, 0, 0, 0, 0},
{0, 0, 0, 0, 0, 0, 15, 84, 123, 105, 53, 29, 20, 11, 11, 11, 11, 19, 29, 62, 100, 118, 92, 0, 0, 0, 0, 0, 0, 0, 0, 0},
{0, 0, 0, 0, 0, 0, 13, 74, 120, 126, 109, 98, 76, 52, 52, 52, 52, 73, 95, 117, 125, 107, 58, 0, 0, 0, 0, 0, 0, 0, 0, 0},
{0, 0, 0, 0, 0, 0, 4, 29, 102, 118, 122, 125, 126, 125, 123, 123, 123, 121, 124, 126, 118, 79, 13, 0, 0, 0, 0, 0, 0, 0, 0, 0},
{0, 0, 0, 0, 0, 0, 0, 2, 14, 34, 62, 103, 122, 102, 72, 72, 72, 36, 96, 126, 107, 57, 1, 0, 0, 0, 0, 0, 0, 0, 0, 0},
{0, 0, 0, 0, 0, 0, 0, 0, 1, 5, 11, 19, 23, 19, 13, 13, 13, 17, 93, 116, 71, 16, 0, 0, 0, 0, 0, 0, 0, 0, 0, 0},
{0, 0, 0, 0, 0, 0, 0, 0, 0, 0, 0, 0, 0, 0, 0, 0, 0, 49, 106, 87, 33, 2, 0, 0, 0, 0, 0, 0, 0, 0, 0, 0},
{0, 0, 0, 0, 0, 0, 0, 0, 0, 0, 0, 0, 0, 0, 0, 1, 22, 91, 118, 70, 16, 0, 0, 0, 0, 0, 0, 0, 0, 0, 0, 0},
{0, 0, 0, 0, 0, 0, 0, 0, 0, 0, 0, 0, 0, 0, 0, 3, 55, 114, 111, 53, 8, 0, 0, 0, 0, 0, 0, 0, 0, 0, 0, 0},
{0, 0, 0, 0, 0, 0, 0, 0, 0, 0, 0, 0, 0, 0, 0, 5, 85, 119, 83, 28, 0, 0, 0, 0, 0, 0, 0, 0, 0, 0, 0, 0},
{0, 0, 0, 0, 0, 0, 0, 0, 0, 0, 0, 0, 0, 0, 2, 16, 111, 120, 52, 9, 0, 0, 0, 0, 0, 0, 0, 0, 0, 0, 0, 0},
{0, 0, 0, 0, 0, 0, 0, 0, 0, 0, 0, 0, 0, 0, 10, 59, 122, 116, 36, 0, 0, 0, 0, 0, 0, 0, 0, 0, 0, 0, 0, 0},
{0, 0, 0, 0, 0, 0, 0, 0, 0, 0, 0, 0, 0, 0, 19, 102, 125, 89, 25, 3, 9, 10, 0, 0, 0, 0, 0, 0, 0, 0, 0, 0},
{0, 0, 0, 0, 0, 0, 0, 0, 0, 0, 0, 0, 0, 0, 19, 105, 125, 86, 49, 63, 77, 47, 0, 0, 0, 0, 0, 0, 0, 0, 0, 0},
{0, 0, 0, 0, 0, 0, 0, 0, 0, 0, 0, 0, 0, 0, 19, 105, 125, 114, 104, 92, 63, 24, 0, 0, 0, 0, 0, 0, 0, 0, 0, 0},
{0, 0, 0, 0, 0, 0, 0, 0, 0, 0, 0, 0, 0, 0, 11, 65, 106, 95, 71, 47, 22, 4, 0, 0, 0, 0, 0, 0, 0, 0, 0, 0},
{0, 0, 0, 0, 0, 0, 0, 0, 0, 0, 0, 0, 0, 0, 3, 19, 51, 39, 16, 3, 1, 0, 0, 0, 0, 0, 0, 0, 0, 0, 0, 0},
{0, 0, 0, 0, 0, 0, 0, 0, 0, 0, 0, 0, 0, 0, 0, 0, 0, 0, 0, 0, 0, 0, 0, 0, 0, 0, 0, 0, 0, 0, 0, 0},
{0, 0, 0, 0, 0, 0, 0, 0, 0, 0, 0, 0, 0, 0, 0, 0, 0, 0, 0, 0, 0, 0, 0, 0, 0, 0, 0, 0, 0, 0, 0, 0},
{0, 0, 0, 0, 0, 0, 0, 0, 0, 0, 0, 0, 0, 0, 0, 0, 0, 0, 0, 0, 0, 0, 0, 0, 0, 0, 0, 0, 0, 0, 0, 0}}}