ap_int<8> image_array[1][32][32] = {{{0, 0, 0, 0, 0, 0, 0, 0, 0, 0, 0, 0, 0, 0, 0, 0, 0, 0, 0, 0, 0, 0, 0, 0, 0, 0, 0, 0, 0, 0, 0, 0},
{0, 0, 0, 0, 0, 0, 0, 0, 0, 0, 0, 0, 0, 0, 0, 0, 0, 0, 0, 0, 0, 0, 0, 0, 0, 0, 0, 0, 0, 0, 0, 0},
{0, 0, 0, 0, 0, 0, 0, 0, 0, 0, 0, 0, 0, 0, 0, 0, 0, 0, 0, 0, 0, 0, 0, 0, 0, 0, 0, 0, 0, 0, 0, 0},
{0, 0, 0, 0, 0, 0, 0, 0, 0, 0, 0, 0, 0, 0, 0, 0, 0, 0, 0, 0, 0, 0, 0, 0, 0, 0, 0, 0, 0, 0, 0, 0},
{0, 0, 0, 0, 0, 0, 0, 0, 0, 0, 0, 0, 0, 0, 8, 34, 54, 46, 18, 3, 0, 0, 0, 0, 0, 0, 0, 0, 0, 0, 0, 0},
{0, 0, 0, 0, 0, 0, 0, 0, 0, 0, 0, 0, 0, 3, 25, 93, 124, 112, 53, 12, 0, 0, 0, 0, 0, 0, 0, 0, 0, 0, 0, 0},
{0, 0, 0, 0, 0, 0, 0, 0, 0, 0, 0, 0, 1, 12, 50, 125, 125, 126, 76, 23, 0, 0, 0, 0, 0, 0, 0, 0, 0, 0, 0, 0},
{0, 0, 0, 0, 0, 0, 0, 0, 0, 0, 0, 2, 9, 42, 105, 125, 125, 126, 78, 26, 3, 1, 0, 0, 0, 0, 0, 0, 0, 0, 0, 0},
{0, 0, 0, 0, 0, 0, 0, 0, 0, 0, 0, 29, 68, 100, 124, 125, 125, 126, 96, 65, 41, 20, 0, 0, 0, 0, 0, 0, 0, 0, 0, 0},
{0, 0, 0, 0, 0, 0, 0, 0, 0, 0, 0, 63, 116, 121, 125, 125, 125, 126, 120, 114, 104, 72, 16, 0, 0, 0, 0, 0, 0, 0, 0, 0},
{0, 0, 0, 0, 0, 0, 0, 0, 0, 0, 43, 99, 126, 126, 126, 126, 126, 121, 117, 121, 124, 113, 77, 0, 0, 0, 0, 0, 0, 0, 0, 0},
{0, 0, 0, 0, 0, 0, 0, 0, 0, 14, 75, 116, 126, 126, 126, 124, 98, 77, 68, 80, 106, 126, 108, 27, 2, 0, 0, 0, 0, 0, 0, 0},
{0, 0, 0, 0, 0, 0, 0, 0, 6, 57, 102, 122, 126, 123, 115, 97, 47, 26, 19, 31, 77, 122, 117, 79, 28, 5, 0, 0, 0, 0, 0, 0},
{0, 0, 0, 0, 0, 0, 0, 1, 16, 99, 123, 126, 122, 104, 72, 44, 6, 0, 0, 6, 48, 105, 125, 120, 81, 20, 2, 0, 0, 0, 0, 0},
{0, 0, 0, 0, 0, 0, 0, 1, 17, 105, 125, 123, 103, 57, 6, 0, 0, 0, 0, 0, 21, 70, 121, 126, 125, 38, 5, 0, 0, 0, 0, 0},
{0, 0, 0, 0, 0, 0, 0, 1, 17, 105, 125, 108, 59, 10, 0, 0, 0, 0, 0, 0, 7, 42, 105, 126, 125, 41, 7, 0, 0, 0, 0, 0},
{0, 0, 0, 0, 0, 0, 0, 1, 17, 106, 126, 59, 4, 0, 0, 0, 0, 0, 0, 0, 7, 42, 106, 127, 126, 87, 24, 0, 0, 0, 0, 0},
{0, 0, 0, 0, 0, 0, 0, 4, 56, 113, 125, 55, 0, 0, 0, 0, 0, 0, 0, 0, 21, 70, 122, 126, 125, 48, 9, 0, 0, 0, 0, 0},
{0, 0, 0, 0, 0, 0, 0, 6, 90, 120, 125, 55, 0, 0, 0, 0, 0, 0, 5, 15, 54, 105, 125, 126, 118, 35, 5, 0, 0, 0, 0, 0},
{0, 0, 0, 0, 0, 0, 0, 7, 101, 122, 125, 55, 0, 0, 0, 0, 0, 0, 31, 67, 100, 122, 124, 114, 70, 18, 2, 0, 0, 0, 0, 0},
{0, 0, 0, 0, 0, 0, 0, 7, 101, 122, 125, 55, 0, 0, 0, 0, 0, 32, 73, 109, 125, 125, 121, 96, 22, 3, 0, 0, 0, 0, 0, 0},
{0, 0, 0, 0, 0, 0, 0, 7, 101, 122, 126, 61, 11, 19, 36, 39, 39, 90, 111, 121, 126, 126, 114, 58, 4, 0, 0, 0, 0, 0, 0, 0},
{0, 0, 0, 0, 0, 0, 0, 6, 93, 121, 126, 85, 53, 72, 118, 126, 126, 127, 127, 126, 126, 123, 95, 0, 0, 0, 0, 0, 0, 0, 0, 0},
{0, 0, 0, 0, 0, 0, 0, 3, 50, 111, 125, 126, 126, 125, 125, 125, 125, 126, 125, 124, 121, 103, 56, 0, 0, 0, 0, 0, 0, 0, 0, 0},
{0, 0, 0, 0, 0, 0, 0, 1, 17, 97, 122, 126, 126, 125, 125, 125, 125, 126, 119, 105, 65, 19, 7, 0, 0, 0, 0, 0, 0, 0, 0, 0},
{0, 0, 0, 0, 0, 0, 0, 0, 2, 38, 70, 106, 126, 125, 125, 125, 125, 126, 84, 38, 11, 2, 1, 0, 0, 0, 0, 0, 0, 0, 0, 0},
{0, 0, 0, 0, 0, 0, 0, 0, 0, 8, 18, 46, 79, 107, 120, 96, 65, 64, 38, 12, 0, 0, 0, 0, 0, 0, 0, 0, 0, 0, 0, 0},
{0, 0, 0, 0, 0, 0, 0, 0, 0, 0, 0, 9, 25, 43, 51, 36, 17, 16, 9, 3, 0, 0, 0, 0, 0, 0, 0, 0, 0, 0, 0, 0},
{0, 0, 0, 0, 0, 0, 0, 0, 0, 0, 0, 0, 0, 0, 0, 0, 0, 0, 0, 0, 0, 0, 0, 0, 0, 0, 0, 0, 0, 0, 0, 0},
{0, 0, 0, 0, 0, 0, 0, 0, 0, 0, 0, 0, 0, 0, 0, 0, 0, 0, 0, 0, 0, 0, 0, 0, 0, 0, 0, 0, 0, 0, 0, 0},
{0, 0, 0, 0, 0, 0, 0, 0, 0, 0, 0, 0, 0, 0, 0, 0, 0, 0, 0, 0, 0, 0, 0, 0, 0, 0, 0, 0, 0, 0, 0, 0},
{0, 0, 0, 0, 0, 0, 0, 0, 0, 0, 0, 0, 0, 0, 0, 0, 0, 0, 0, 0, 0, 0, 0, 0, 0, 0, 0, 0, 0, 0, 0, 0}}}