ap_int<8> image_array[1][32][32] = {{{0, 0, 0, 0, 0, 0, 0, 0, 0, 0, 0, 0, 0, 0, 0, 0, 0, 0, 0, 0, 0, 0, 0, 0, 0, 0, 0, 0, 0, 0, 0, 0},
{0, 0, 0, 0, 0, 0, 0, 0, 0, 0, 0, 0, 0, 0, 0, 0, 0, 0, 0, 0, 0, 0, 0, 0, 0, 0, 0, 0, 0, 0, 0, 0},
{0, 0, 0, 0, 0, 0, 0, 0, 0, 0, 0, 0, 0, 0, 0, 0, 0, 0, 0, 0, 0, 0, 0, 0, 0, 0, 0, 0, 0, 0, 0, 0},
{0, 0, 0, 0, 0, 0, 0, 0, 0, 0, 0, 0, 0, 0, 0, 0, 0, 0, 0, 0, 0, 0, 0, 0, 0, 0, 0, 0, 0, 0, 0, 0},
{0, 0, 0, 0, 0, 0, 0, 0, 0, 0, 0, 0, 0, 0, 0, 0, 0, 0, 0, 0, 0, 0, 0, 0, 0, 0, 0, 0, 0, 0, 0, 0},
{0, 0, 0, 0, 0, 0, 0, 0, 0, 0, 0, 0, 0, 0, 0, 0, 0, 0, 0, 0, 0, 0, 0, 0, 0, 0, 0, 0, 0, 0, 0, 0},
{0, 0, 0, 0, 0, 0, 0, 0, 0, 0, 0, 0, 0, 0, 0, 0, 0, 0, 0, 0, 0, 0, 0, 0, 0, 0, 0, 0, 0, 0, 0, 0},
{0, 0, 0, 0, 0, 0, 0, 0, 0, 0, 0, 0, 0, 0, 0, 1, 1, 4, 5, 6, 5, 2, 1, 0, 0, 0, 0, 0, 0, 0, 0, 0},
{0, 0, 0, 0, 0, 0, 0, 0, 0, 0, 0, 0, 0, 0, 3, 17, 26, 57, 85, 94, 72, 36, 14, 0, 0, 0, 0, 0, 0, 0, 0, 0},
{0, 0, 0, 0, 0, 0, 0, 0, 0, 0, 0, 0, 8, 31, 68, 99, 108, 114, 120, 122, 117, 110, 101, 84, 63, 13, 1, 0, 0, 0, 0, 0},
{0, 0, 0, 0, 0, 0, 0, 0, 0, 0, 11, 36, 69, 96, 113, 123, 118, 100, 89, 108, 118, 114, 123, 111, 101, 49, 11, 0, 0, 0, 0, 0},
{0, 0, 0, 0, 0, 0, 0, 0, 0, 35, 66, 92, 113, 119, 106, 93, 54, 39, 31, 73, 85, 72, 112, 119, 112, 97, 33, 2, 0, 0, 0, 0},
{0, 0, 0, 0, 0, 0, 0, 3, 26, 85, 114, 122, 112, 85, 52, 37, 4, 0, 0, 56, 65, 36, 81, 124, 118, 125, 47, 4, 0, 0, 0, 0},
{0, 0, 0, 0, 0, 0, 3, 18, 77, 118, 124, 103, 69, 31, 3, 0, 0, 0, 3, 53, 72, 53, 74, 127, 127, 115, 41, 3, 0, 0, 0, 0},
{0, 0, 0, 0, 0, 0, 7, 41, 116, 126, 117, 67, 23, 14, 16, 16, 16, 20, 31, 54, 89, 117, 123, 127, 125, 79, 23, 1, 0, 0, 0, 0},
{0, 0, 0, 0, 0, 0, 6, 40, 113, 125, 117, 82, 65, 78, 91, 91, 87, 102, 119, 120, 121, 127, 126, 123, 110, 35, 5, 0, 0, 0, 0, 0},
{0, 0, 0, 0, 0, 0, 1, 11, 84, 116, 124, 124, 123, 124, 124, 123, 124, 125, 126, 126, 126, 126, 119, 84, 23, 4, 0, 0, 0, 0, 0, 0},
{0, 0, 0, 0, 0, 0, 0, 2, 15, 27, 63, 92, 100, 91, 83, 87, 104, 123, 127, 127, 127, 114, 73, 21, 3, 0, 0, 0, 0, 0, 0, 0},
{0, 0, 0, 0, 0, 0, 0, 0, 0, 2, 15, 26, 29, 26, 23, 28, 83, 119, 127, 124, 101, 58, 20, 2, 0, 0, 0, 0, 0, 0, 0, 0},
{0, 0, 0, 0, 0, 0, 0, 0, 0, 0, 0, 0, 0, 0, 6, 37, 101, 123, 127, 99, 53, 15, 0, 0, 0, 0, 0, 0, 0, 0, 0, 0},
{0, 0, 0, 0, 0, 0, 0, 0, 0, 0, 0, 0, 0, 7, 34, 88, 123, 126, 120, 66, 15, 0, 0, 0, 0, 0, 0, 0, 0, 0, 0, 0},
{0, 0, 0, 0, 0, 0, 0, 0, 0, 0, 0, 0, 4, 28, 81, 123, 126, 125, 95, 37, 1, 0, 0, 0, 0, 0, 0, 0, 0, 0, 0, 0},
{0, 0, 0, 0, 0, 0, 0, 0, 0, 0, 0, 0, 15, 61, 122, 127, 126, 108, 49, 10, 0, 0, 0, 0, 0, 0, 0, 0, 0, 0, 0, 0},
{0, 0, 0, 0, 0, 0, 0, 0, 0, 0, 0, 0, 30, 87, 127, 126, 120, 47, 9, 0, 0, 0, 0, 0, 0, 0, 0, 0, 0, 0, 0, 0},
{0, 0, 0, 0, 0, 0, 0, 0, 0, 0, 0, 3, 56, 123, 127, 124, 81, 16, 0, 0, 0, 0, 0, 0, 0, 0, 0, 0, 0, 0, 0, 0},
{0, 0, 0, 0, 0, 0, 0, 0, 0, 0, 3, 55, 108, 126, 123, 103, 23, 3, 0, 0, 0, 0, 0, 0, 0, 0, 0, 0, 0, 0, 0, 0},
{0, 0, 0, 0, 0, 0, 0, 0, 0, 0, 20, 82, 125, 127, 113, 52, 4, 0, 0, 0, 0, 0, 0, 0, 0, 0, 0, 0, 0, 0, 0, 0},
{0, 0, 0, 0, 0, 0, 0, 0, 0, 0, 52, 105, 127, 116, 79, 13, 1, 0, 0, 0, 0, 0, 0, 0, 0, 0, 0, 0, 0, 0, 0, 0},
{0, 0, 0, 0, 0, 0, 0, 0, 0, 0, 74, 119, 125, 98, 35, 0, 0, 0, 0, 0, 0, 0, 0, 0, 0, 0, 0, 0, 0, 0, 0, 0},
{0, 0, 0, 0, 0, 0, 0, 0, 0, 0, 66, 113, 114, 69, 7, 0, 0, 0, 0, 0, 0, 0, 0, 0, 0, 0, 0, 0, 0, 0, 0, 0},
{0, 0, 0, 0, 0, 0, 0, 0, 0, 0, 31, 78, 77, 30, 0, 0, 0, 0, 0, 0, 0, 0, 0, 0, 0, 0, 0, 0, 0, 0, 0, 0},
{0, 0, 0, 0, 0, 0, 0, 0, 0, 0, 0, 0, 0, 0, 0, 0, 0, 0, 0, 0, 0, 0, 0, 0, 0, 0, 0, 0, 0, 0, 0, 0}}}